1 1 1 3 3 3 3 8 3 3 
1 1 1 3 3 3 3 1 1 3 
1 1 1 1 3 3 1 1 1 3 
1 1 1 1 1 1 1 1 3 3 
1 1 1 1 1 1 1 1 3 3 
1 1 1 1 1 1 1 1 7 3 
3 1 1 1 1 1 1 7 7 1 
3 3 3 1 1 1 7 7 5 5 
3 3 3 3 3 7 7 5 5 5 
3 3 3 3 3 5 5 5 5 6 
