5 5 5 5 5 5 5 5 5 5 
7 7 5 5 5 5 5 7 7 7 
7 7 7 7 7 7 7 7 7 7 
4 4 7 7 7 7 7 7 4 4 
4 4 4 4 4 4 4 4 4 4 
1 1 4 4 4 4 4 4 1 1 
3 1 1 4 4 4 4 1 1 3 
3 3 1 1 4 4 4 1 1 3 
3 3 1 1 4 4 1 1 3 3 
3 3 1 1 4 4 1 1 3 3 
